NO ./textures/tex_arrow_up.xpm
SO ./textures/tex_arrow_down.xpm
WE ./textures/tex_arrow_left.xpm
EA ./textures/tex_arrow_right.xpm

F 220,100,0
C 225,30,0

        1111111111111111111111111
        100000000N110000000000001
        1011000001110000000000001
        1001000000000000000000001
111111111011000001110000000000001
100000000011000001110111111111111
11110111111111011100000010001
111101111111110111010100100E1
11000000110101011100000010001
1W000000000000001100000010001
10000000000000001101010010001
1100000111010101111101111000111
11110111 11101S1 101111010001
11111111 1111111 111111111111
