  	EA 	  ./path_to_the_east_texture.xpm
	NO./path_to_the_north_texture.xpm   
	C 225,    30   ,   0




  SO                         ./path_to_the_south_texture.xpm
F 	220,100,0
      
 
    
   
WE                 ./path_to_the_west_texture.xpm
                                                   1                           
                                                   1                           
                                                   1                           
    11111111111111111111111111111111111111111111111111                           
    10000000000000000000000000000000000000000000000001                            
    10000011111110111011111111111111110011111111111111
    100000111111101 101               1001
    100000111111101 1011111            1001
    100000000000001 1000001             1001
    101111111000001 1111101              1001
    10101010100001      101               1001
    1011111110001   1111101                1001
    100000000001   10000001                 1001
    1111100000001 10001111111       1        1001
     10000N001000100000000001                 1001111111111
    111110001 1000000011111001               1001
    10000001 1 1000000000011001             1001
    1011111 1 100011111110111001           1001
    101 1 1  10000100000101111001         1001
    101111111001001011111011111001       1001
    1000001 10000010100000111111001     1001 
    11111011101110101011111111111001   1001
        101 101 101010111111111111001 1001
        101110111011101111111111111001001
        10000000000000100010001000110001
    11111111111111111000100010001011111    1 1
    100000000000000011111111111110000111111 1 1
    10000000000000001111111100011111011
    10000000000000001000011001000100011
    10000000000000001011010011110101111
    10000000000000001000000111110001111
    11111111111111111111111111111111111